[
    {
        "width": 8,
        "tiles": [
            1, 3, 1, 1, 3, 1, 1, 1,
            1, 0, 0, 2, 0, 0, 0, 1,
            1, 4, 0, 3, 4, 0, 0, 3,
            2, 0, 0, 0, 0, 0, 4, 3,
            1, 4, 0, 1, 3, 1, 0, 1,
            1, 0, 1, 2, 0, 0, 0, 1,
            6, 5, 6, 1, 0, 4, 4, 1,
            1, 7, 3, 1, 1, 3, 1, 1
        ],
        "things": [
            0, 0, 0, 0, 0, 0, 0, 0,
            0, 2, 0, 0, 0, 0, 0, 0,
            0, 0, 0, 0, 2, 0, 0, 0,
            0, 0, 0, 3, 0, 0, 0, 0,
            0, 0, 2, 0, 4, 0, 3, 0,
            0, 3, 0, 0, 0, 0, 0, 0,
            0, 0, 0, 0, 1, 0, 2, 0,
            0, 5, 0, 0, 0, 0, 0, 0
        ]
    },
    {
        "width": 5,
        "tiles": [
            2, 1, 1, 6, 1,
            1, 0, 4, 5, 7,
            1, 1, 1, 6, 1,
            2, 0, 0, 1, 3,
            1, 0, 3, 1, 3,
            1, 1, 1, 1, 1
        ],
        "things": [
            0, 0, 0, 0, 0,
            0, 1, 3, 0, 5,
            0, 4, 0, 0, 0,
            0, 0, 2, 0, 0,
            0, 0, 0, 0, 0,
            0, 0, 0, 0, 0
        ]
    }
]
