[
    {
        "seed": 1,
        "width": 8,
        "monsters": 5,
        "medkits": 2,
        "shotguns": 1,
        "pushwalls": 1,
        "tiles": [
            1, 3, 1, 1, 3, 1, 1, 1,
            1, 0, 0, 2, 0, 0, 0, 1,
            1, 4, 0, 3, 4, 0, 0, 3,
            2, 0, 0, 0, 0, 0, 4, 3,
            1, 4, 0, 1, 3, 1, 0, 1,
            1, 0, 1, 2, 0, 0, 0, 1,
            6, 5, 6, 1, 0, 4, 4, 1,
            1, 7, 3, 1, 1, 3, 1, 1
        ]
    }
]
