{
    "width": 8,
    "tiles": [
        1, 3, 1, 1, 3, 1, 1, 1,
        1, 0, 0, 2, 0, 0, 0, 1,
        1, 4, 0, 3, 4, 0, 0, 3,
        2, 0, 0, 0, 0, 0, 4, 3,
        1, 4, 0, 1, 1, 1, 0, 1,
        1, 0, 4, 2, 0, 0, 0, 1,
        1, 0, 0, 1, 0, 4, 4, 1,
        1, 3, 3, 1, 1, 3, 1, 1
    ],
    "things": [
        0, 0, 0, 0, 0, 0, 0, 0,
        0, 2, 0, 0, 0, 0, 0, 0,
        0, 0, 0, 0, 0, 0, 2, 0,
        0, 0, 0, 0, 0, 0, 0, 0,
        0, 0, 0, 0, 0, 0, 0, 0,
        0, 0, 2, 0, 0, 0, 0, 0,
        0, 0, 0, 0, 1, 0, 2, 0,
        0, 0, 0, 0, 0, 0, 0, 0
    ]
}
